1111111111111111111111111111111111111111
10X0100000000000000000000000000000000001
1000100000000000000000000000000000000001
1000100000000000000000000000000000000001
1000111111111111110000011111111111111111
1000000000000000000000000000000000000001
1000000000000000000000000000000000000001
1000000000000000000000000000000000000001
1000011111111111111111111111111000000001
1000010000000000000000000000001000000001
1000010000000000000000000000001000000001
1000010000000000000000000000001000000001
1000010000000000000000000000001000000001
1000011111111111111111111100001000000001
1000000000000000000000000000000000000001
1000000000000000000000000010000000000001
1000000000000000000000000000000000000001
1111111110000111111111111111111111111111
1000000010000100000000000000000000000001
1000000010000100000000000000000000000001
1000000010000100000000000000000000000001
1000000010000100000000000000000000000001
1000001110000100000011111111111111111111
1000000000000000000000000000000000000001
1000000000000000000000000000000000000001
1000000000000000000000000000000000000001
1000000000000000000000000000000000000001
1111111111111111111111111111111111111111
