11111111
1X100001
10101111
10000001
10111101
10001001
11111101
10101101
10000001
11101111
10000001
11111101
11111101
11111111
